Indicator
#16-1-1-a
#16-1-2-a
#16-1-3-a
#16-2-1-a
#16-5-3-a
#16-8-4-a
#5-3-1-a
#7-1-2-a
