Indicator
#5-6-1-a
#6-3-1-a
#6-3-2-a
#8-5-3-a
#8-6-1-a
#9-5-2-a
